1111111
10C0001
1000001
1P00001
1111111