1111111
10C0001
1000E01
1000001
1111111