1111111
10C00E1
1000001
1P00.01
1111111