1111111
10C00E1
1000001
1P0001
111111