1111111111111
1000000000001
1001C01000C01
1001110000001
1C00011110001
100100C0110E1
1000000000111
1000000010001
100000C001001
1P000000010C1
1111111111111