11111111111111111111111111
10000000000000000000000001
10000000000000000000000001
100C00011111100C0000000001
10000001000001000000000001
10000001000001000000000001
10000001111110000000000001
10000001C01000000000000001
100000010001C0000000000001
10P000010E001000000C000001
10000000000000000000000001
11111111111111111111111111
